XXXXXXXXXXXXXXXXXXXXXXXXXXXXXXXXXXXXXXXXXXXXXXXXXXXXXXXXXXXXXXXXXXXXXXXXXXXXXXXXXXXXXXXXXXXXXXXXXXXXXXXXXXXXXXXXXXXXXXXXXXXXXXXXXXXXXXXXXXXXXXXXXXXXXXXXXXXXXXXXXXXXXXXXXXXXXXXXXXXXXXXXXXXXXXXXXXXXXXXXXXXXXXXXXXXXXXXXXXXXXXXXXXXXXXXXXXXXXXXXXXXXXXXXXXXXXXXXXXXXXXXXXXXXXXXXXXXXXXXXXXXXXXXXXXXXXXXXXXXXX
P           X           X       X         X             X X               X           X             X               X             X         X     X                 X           X   X       X     X         X   X X     X         X             X   X       X   X       X       X     X   X     X       X   X
XXXXX XXXXX X XXX XXXXX X XXX X XXXXXXX X X XXXXXXX XXX X X X XXXXXXXXXXXXX XXX XXXXX X XXXXX XXXXXXX X XXXXXXXXXXX XXXXXXXXX XXX XXX XXXXX XXX X XXXXXXX X XXXXXXX X X XXXXXXXXX X X XXX X XXX X XXX XXX X X X X X XXX XXXXXXX X X X XXXXXXXXX X X XXXXX XXX X X X XXX X XXXXX XXX X X X X XXX XXX XXX XXX X
X   X   X   X   X   X   X   X X       X X X   X   X X X X X X               X X   X   X X   X X       X   X     X   X   X   X   X     X   X X   X     X   X X     X X X X   X     X X   X X X   X   X X   X   X X X X X X     X X   X X       X   X     X     X   X X X   X     X   X   X   X X     X X     X
X X XXX X XXXXX XXX X XXXXX X XXXXXXX XXX XXX X X X X X X X XXXXXXXXXXXXX XXX XXX X XXX X X X X XXXXXXXXX X X XXX XXX X X X XXX XXXXXXX X X X XXXXXXX X XXXXX XXX XXX X X X X XXXXX XXX X X X XXXXX XXX XXXXXXX X X X X X XXX XXX XXX X XXXXX XXXXXXXXX XXX XXXXXXX X XXXXX XXXXX XXXXXXXXXXX XXXXXXX XXXXX X
X X     X   X     X X   X   X X             X X X   X X X X X X     X   X X   X   X X   X X X X       X   X X     X   X   X X   X     X X   X   X X   X     X X X     X   X   X   X     X X   X   X     X     X X X X     X X   X X X X   X X     X   X   X X     X X     X X       X X   X           X     X
X XXXXXXXXX XXXXXXX XXX X XXX XXXXX XXXXXXXXX X XXXXX X X X X X XXX X X X X XXX XXX X XXX X XXXXXXXXX X XXX XXXXXXX XXXXXXX X X X XXX X XXXXXXX X X XXXXXXX X X XXXXXXXXXXXXXXX XXXXXXXXX XXXXX X XXXXX X XXX X X X XXXXXXX XXX X X X XXX X XXXXX X X XXX XXX XXX X X X XXX XXXXXXX X X X X X XXXXXXXXX XXXXX
X X       X       X X   X X X     X   X       X   X   X X X X     X X X X   X   X X X   X X           X X   X       X     X X X X X X X         X X X       X       X         X         X   X   X   X   X   X X   X   X   X   X X   X X X     X X   X   X     X X   X X     X       X   X   X     X   X   X X
X XXX X X XXXXXXX X XXXXX X XXXXX XXXXX XXXXXXXXX X X X X X XXX XXX X X XXXXX XXX X XXX X XXXXXXXXXXXXX X XXXXXXX XXX XXXXX X XXX X X XXXXXXXXXXX X X XXXXX XXXXXXX X XXXXXXX XXX XXXXXXXXX XXXXXXX X XXXXX X XXXXXXX XXX X X X XXXXX X XXXXX X XXXXX X XXXXXXX XXXXX XXXXXXX XXXXXXX XXXXXXXXXXX X X XXX X X
X   X X X     X   X     X X     X       X         X X X X X   X X   X X     X X   X X   X X         X X X     X   X         X       X X   X       X X     X X   X X X       X   X     X   X       X       X X       X   X X X X       X X     X X     X X         X X X     X X     X   X       X X X X   X X
XXX X X XXXXXXX XXX XXX X X XXX XXXXXXXXX XXXXXXXXX XXX X XXX X X X X XXXXX X X X X X XXX XXXXXXX X X X XXXXX X XXX XXXXXXXXX XXXXXXX X X X XXX XXX XXXXX X X X X X XXXXX X XXX X XXX X X XXXXXXX XXXXXXXXX XXXXX X XXX X X X XXXXXXXXX X XXXXX X XXX XXX XXX XXX X X XXX X X X XXXXXXX X XXXXX X X X X XXX X
X   X X   X     X X X X X   X     X   X   X X     X   X X     X X X X     X X X X X X   X         X   X   X     X X     X     X X   X X X   X X         X X   X   X     X X X X X X   X X   X     X         X     X X X X   X           X     X X   X X   X X   X X X     X   X         X X   X   X X X   X X
X XXXXX X X XXXXX X X X XXXXX XXXXX X X XXX X XXX X X X XXXXX XXX X XXXXX X X X XXX X X XXXXXXXXXXXXX XXX XXXXXXX XXXXX X XXXXX X X X XXX XXX XXXXXXXXX X XXXXXXXXXXXXX XXX X X XXX XXX XXX X XXX X XXXXXXXXX XXXXX X X XXX X XXX XXXXXXXXXXX X XXX XXX XXX XXX X X XXXXXXXXXXX XXXXXXXXX XXX X XXX X XXX X X
X     X X X   X   X   X   X   X     X   X X     X   X       X     X   X   X   X X   X X         X   X   X     X     X   X       X X X   X     X       X   X           X     X X   X   X   X   X   X   X     X   X X X X   X X   X X         X     X         X   X             X X       X   X   X   X     X X
XXXXX X X XXX X X XXX XXX X XXX XXXXXXXXX X XXXXX XXXXXXXXX XXXXXXXXX X XXXXXXX X XXX XXX XXXXX X XXXXX XXXXX X X XXX XXXXXXXXXXX X XXX X XXXXX XXXXX XXX X XXXXXXXXX XXXXXXX XXX XXX XXX XXXXX XXXXX X X X XXX X X X XXX XXXXX XXX XXXXX XXXXX XXXXXXXXXXXXX XXXXXXXXXXX XXXXX XXX XXXXXXX X XXX XXXXXXXXX X
X     X X   X X X       X     X     X X     X   X X   X         X   X X X X     X X   X X X     X X       X   X X X   X           X     X X     X X   X   X   X X           X   X   X   X   X     X X X X X X   X X   X X X   X X       X       X   X     X   X   X       X   X   X       X X   X X         X
X XXXXX XXX X X XXXXXXXXXXX XXXXXXX X X XXXXX X XXX X XXXXXXXXX X X XXX X X X XXX X XXX X XXX XXX X XXXXXXX XXX X X XXXXX XXXXXXXXXXXXXXX X XXXXX X XXXXXXXXX X X XXXXXXXXX XXX XXX X X XXX XXXXX X X XXX X X XXX XXX X X X X X X XXXXX XXXXXXXXXXX X XXX X XXX XXX XXXXXXX X XXX X XXXXX X XXXXX X XXX XXX X
X X   X X X X X X     X   X X   X   X   X     X   X X         X   X X   X X X     X     X   X     X     X   X   X X     X X             X X X     X           X X         X     X   X X   X   X X   X     X X X X     X X   X X   X   X     X       X   X X X   X   X X     X X   X     X X   X   X   X X   X
X X X X X X X X X XXX X X XXX X X X XXXXX XXXXXXX X XXXXXXXXX XXXXX X XXX X XXXXXXXXXXX XXX XXXXX XXXXX X XXX XXX XXXXX X X XXXXXXXXXXX XXX X X XXXXXXXXXXXXXXX XXXXXXXXX XXXXX X XXX XXXXXXX X XXX XXX XXXXX X X XXXXX XXXXX XXXXX X XXXXXXX XXXXXXXXX X X X XXX XXX X XXXXX X XXXXX XXX XXX X XXXXXXX X XXX
X X X X X X X X   X X X X X   X   X X   X   X   X X     X   X   X     X   X X         X   X X         X X X X   X     X X X         X   X   X X X               X     X X X     X     X       X   X X X X     X             X       X       X   X     X X   X X       X X     X X   X X   X X   X       X   X
X X XXX X X X XXXXX X X X X XXXXXXX X X XXX X X X XXXXX X XXXXX X XXXXX X X XXX XXXXX XXXXX XXXXXXXXXXX X X XXX X XXX X X XXX XXXXXXX X X XXX X X XXX XXXXXXXXX X XXX X X XXX XXXXXXX X XXXXXXX X X X X X XXX XXXXX XXXXX XXXXXXXXXXXXXXXXX XXX X XXX X XXXXX X XXXXXXX X XXXXX X XXX X X X XXXXX X XXXXXXX X
X X       X       X   X X   X X     X X   X X X X     X X X     X X   X X   X   X X         X         X X X     X X   X X   X X       X X   X X   X   X       X   X   X X   X   X     X   X     X     X X   X X   X X   X X           X   X     X X   X   X     X       X       X X   X X   X   X X X     X X
X XXXXXXX XXXXXXX XXXXX XXXXX X XXXXX XXX X XXX XXX XXX X X X XXXXX X XXX XXX XXX X XXXXXXX X XXXXXXX X X XXX XXX XXXXX XXX X X XXXXXXX XXX X XXXXX XXXXX XXX XXXXX XXX XXX XXX X XXXXXXX XXXXXXXXXXXXX XXX XXX X XXX X XXX XXXXX X X XXX XXXXXXX X XXX X XXXXX X XXXXXXXXXXXXXXX X XXX XXX X X X X X XXX X X
X     X   X   X       X     X       X X X         X   X   X X X     X   X X     X   X     X X X     X   X   X   X     X X   X X X   X   X   X X     X   X   X X   X X   X   X   X     X   X     X     X X X     X   X X X   X   X X X         X   X   X X     X X X   X   X     X X X   X   X X X X X X   X X
X XXX X XXX X XXXXXXX XXXXX XXXXXXXXX X XXXXXXXXXXXXX XXX X XXX XXXXXXX X XXX X XXXXX XXX XXX X XXX XXXXXXX XXX XXXXX X X XXX X X X X XXX XXXXX XXXXX X X X XXX X X XXX X XXX XXX XXXXX XXX XXX X XXX X X XXXXXXXXX X X X XXX X XXX XXXXX XXXXX X XXX XXXXXXX XXX X XXX X X X X X X X XXX XXX X X X X X XXXXX
X   X X   X X     X   X   X   X     X   X   X       X   X X   X X       X   X X   X   X X     X X X X       X   X X   X X X   X X X X X X   X   X     X X X   X X X     X   X X   X   X X   X X   X X   X X   X   X   X     X X   X X     X   X X   X X     X X   X     X   X X X   X X X X   X   X   X     X
XXX X XXXXX XXXXX X XXX X X X X XXX XXX X XXX XXXXX XXX X XXX X X XXXXXXXXX XXXXX X XXX XXXXXXX X X X XXXXXXX XXX X XXX X X XXX X X X X XXX X XXX XXXXX XXXXX X X XXXXX XXX X X XXX X X X XXX XXXXX XXXXX X X X X X XXXXXXXXX XXX X XXXXXXX X X XXX X X XXX X X XXX XXXXXXXXX X XXXXX X X X XXXXXXXXXXX XXX X
X X X X       X   X   X X X X X   X     X   X X   X     X X X   X     X           X X           X   X X     X     X     X X X   X X X X   X X X   X   X       X X X     X X X X X   X   X X         X     X X   X X   X   X   X   X X       X X X X X X X X   X   X       X   X     X X X X     X     X X   X
X X X X XXXXXXX XXXXX X X X X XXX XXXXXXXXX X XXX XXXXX X X XXXXXXXXX XXXXXXXXXXX X XXXXXXX X X XXXXX XXX X XXXXX XXXXXXX X X XXX X X X X X X X XXX X XXXXXXXXX X X XXXXX X XXX X XXXXXXX X XXXXXXX XXXXX X XXXXX XXXXX X X XXX XXX X XXXXXXX X X X X X X XXX XXX XXXXXXXXX XXXXXXX X X X XXXXX X XXX XXX X X
X   X   X       X   X   X X X   X   X       X   X     X X       X   X   X     X   X       X X X X   X   X X     X X         X X X X X X X X X X X   X X         X X   X   X X   X X     X X X     X X     X X   X X   X X X X X     X X     X     X X   X     X X     X   X   X     X X     X   X   X   X X X
X XXXXXXX XXXXXXX XXXXXXX XXX XXXXX X XXXXX XXX X XXXXX X XXXXXXX X XXX X XXX X XXXXXXXXX XXX XXX X XXX XXXXX XXX XXXXXXXXX X X X X X X XXX X X X XXX X XXXXXXXXX XXX XXX X X XXX X XXX X X XXXXX X X XXXXX X X X X X X X X X XXX XXX X XXXXXXXXXXX XXXXX XXXXX XXXXX X X X X XXX XXX XXXXX X XXXXX XXX X XXX
X X     X X     X       X X   X   X   X     X X X       X X       X   X X X   X   X     X   X     X   X     X       X     X X X   X X X   X X X     X     X         X   X X   X X   X X   X X   X X X X   X   X X   X   X   X X   X   X         X   X   X X         X   X X X   X   X   X   X     X   X X   X
X XXX X X XXXXX X XXX XXX X X X X XXXXX XXXXX X XXXXXXXXX X XXXXXXXXX X X X XXXXX X X XXXXX X XXXXXXX XXXXX XXXXXXX X XXX XXX XXXXX X X X X X XXXXX XXXXXXX XXXXXXXXXXX X XXXXX XXXXX XXXXX X X X X X X X XXXXX XXXXXXXXXXXXX X XXX XXX XXXXX X X XXXXX X XXXXXXX XXXXXXX XXXXX XXX X X X XXXXXXX XXX X XXX X
X   X X X     X   X X X   X X X X       X     X   X       X X   X     X   X X   X X X       X X     X     X     X X X X X   X   X   X X X X X     X     X   X           X       X       X   X X   X X   X X   X X             X X X X   X X   X X     X X     X   X     X   X   X   X X X   X X   X X X     X
XXX XXX XXXXX X XXX X X XXX X X XXXXXXXXXXX X XXX X XXXXXXX X X XXX XXXXXXX X X X X XXXXXXXXX XXX X XXXXX XXXXX X X X X XXX XXX X XXX XXX X XXX X XXXXX X XXX XXXXXXXXXXX XXXXX X X XXX XXX X X XXX XXXXX X X X X XXXXXXX XXXXX X X X XXX X XXX XXXXX X XXXXX X X X XXX XXX X XXX XXXXX XXX X X XXX X XXXXX X
X   X   X     X   X X X     X X   X         X   X       X   X X   X   X     X X   X X       X     X X X       X X     X   X     X     X   X   X X X     X   X     X   X     X X X X X   X   X X X   X   X   X X X       X     X X X X     X X X   X X X     X   X X X     X   X   X     X   X     X X     X X
X XXX X X XXXXXXX X X XXXXXXX XXX XXXXX XXXXXXX XXXXXXXXX X X XXX XXX X XXXXX XXXXX X XXXXXXXXXXXXX X X XXXXXXX X XXXXXXX XXXXXXX XXXXX X XXX XXX XXXXX XXX XXXXX X X X XXX X X XXX X XXX XXX X X XXX X X XXX X XXXXX XXXXX X X X X XXX XXX X XXX X X XXXXX XXX XXX X XXX XXXXX XXX XXXXX XXXXXXX X XXXXX X X
X     X X X     X   X X     X   X       X     X X X       X X   X X X X X   X     X X     X   X       X   X     X X     X   X     X     X   X   X     X   X X     X X   X   X X   X X X   X   X X     X X   X X   X   X   X X     X X   X   X   X   X X       X X   X X       X   X X   X     X X X X   X X X
XXXXX XXX XXXXX XXX X X XXX XXX XXXXXXXXXXXXX X X X XXXXXXX XXX X X X X X X XXXXX X XXX X X X X XXXXXXX X X XXXXXXX XXX X X X XXXXX X XXXXX XXX XXXXX XXX X X XXXXX XXXXX XXX XXX X X X XXX XXXXXXXXXXX XXXXX XXX X XXX X XXXXXXX X XXX X XXX X XXX X X XXXXXXX X XXX XXXXXXX XXX X XXX XXXXX X X X X X X X X
X   X X   X   X     X X X X   X X   X         X X X X       X   X X     X X     X X   X X X X     X   X X X     X   X X X X   X     X X   X   X       X   X   X   X X   X X X     X X X X             X   X   X   X X   X   X   X X   X X X   X X   X X X       X   X X   X   X X X   X     X X     X X   X X
X XXX X XXX X XXXXXXX X X X XXX X X X X XXXXX X X X X XXXXXXX XXX XXXXXXXXXXX XXX XXX X X X XXXXXXX X XXX XXXXX X XXX X XXX XXXXXXXXX X X XXX XXXXXXXXX XXXXXXX XXX X X X X X XXXXX X X XXXXXXXXXXXXX XXX X X X XXX X XXXXX X X XXXXX XXX X XXXXX XXX X X XXXXXXXXX X X X X XXX X X X XXXXX X XXXXXXX XXXXX X
X X   X X   X       X     X   X X X   X X     X X X X X       X X           X   X X   X X   X X     X     X   X X X   X   X   X     X X X           X X X     X       X X X X     X X   X   X       X   X X X X X   X X   X X X X   X     X         X X     X       X   X X     X X X     X         X   X   X
X X XXX X XXXXXXXXX X XXXXX X X X XXXXX X XXXXX X X XXX XXXXXXX XXXXXXXXXXX X X X X XXXXXXX X X XXXXXXXXX XXX X X X XXXXX XXX X XXX X XXXXXXXXXXXXX X X XXX X XXXXXXXXXXX X XXXXX X XXXXX X X XXXXX X X X X X X XXXXX X X X X X X X XXXXXXX XXXXXXXXX X XXXXX XXXXXXXXXXX XXXXXXX XXXXXXX XXXXXXXXX XXX X XXX
X X   X X X     X   X X   X X   X     X X X   X X X X   X         X       X X X X X   X   X   X X X       X   X X X     X   X   X   X X     X     X   X   X X X           X X     X X     X   X       X X X X X X     X X X   X   X     X X X     X   X   X   X   X       X     X   X   X   X     X     X X X
X XXX X X XXXXX X XXXXX X X XXXXXXXXX X X XXX X X X X XXX X XXXXX X XXX XXX X X X XXX X X X XXX X X XXXXXXX XXX X XXXXX XXX XXXXXXX X X XXX X XXX XXXXXXX X X X XXXXXXXXXXX X XXXXX X X XXXXXXXXXXXXXXXXX X XXX X XXXXXXX XXXXXXXXX XXX X X XXX X X XXXXXXX XXXXX X XXXXXXX XXX XXX X X XXX X X XXXXXXXXX X X
X   X X X X   X X X   X X X     X   X X X     X X X   X   X X X   X X   X   X X     X   X X X   X X       X X   X       X X X     X   X   X X X   X       X X   X   X     X   X     X X X           X   X X   X X X     X     X   X X     X X   X X X       X     X   X     X   X   X X     X X         X X X
X XXX X X X X X X X X X X XXXXXXX X X X XXXXXXX X XXXXXXXXX X X XXXXX X X XXXXXXXXXXXXXXX XXX XXX XXXXXXX X X XXXXXXXXX X X X XXX XXXXXXX X X X XXX XXXXXXX XXXXX XXX X XXX XXX XXXXX XXX XXXXXXXXX X X X XXX X X X XXX XXX X X X X XXXXXXX X XXX X X XXXXXXXXX X XXX X XXXXX XXX XXX XXXXXXX XXXXXXX XXX X X
X     X     X   X   X   X         X   X                     X         X X                     X             X             X     X         X   X             X         X         X                 X   X       X     X       X   X X           X   X             X   X       X         X             X       K
XXXXXXXXXXXXXXXXXXXXXXXXXXXXXXXXXXXXXXXXXXXXXXXXXXXXXXXXXXXXXXXXXXXXXXXXXXXXXXXXXXXXXXXXXXXXXXXXXXXXXXXXXXXXXXXXXXXXXXXXXXXXXXXXXXXXXXXXXXXXXXXXXXXXXXXXXXXXXXXXXXXXXXXXXXXXXXXXXXXXXXXXXXXXXXXXXXXXXXXXXXXXXXXXXXXXXXXXXXXXXXXXXXXXXXXXXXXXXXXXXXXXXXXXXXXXXXXXXXXXXXXXXXXXXXXXXXXXXXXXXXXXXXXXXXXXXXXXXXXXX
